{
  "start_position": {
    "x": 100,
    "y": 100
  },
  "tiles": [
    false,
    "data/images/level_1/tile_1.png",
    "data/images/level_1/wall_1.png",
    "data/images/level_1/wall_2.png",
    "data/images/level_1/wall_3.png",
    "data/images/level_1/wall_4.png",
    "data/images/level_1/wall_5.png",
    "data/images/level_1/wall_6.png",
    "data/images/level_1/wall_7.png",
    "data/images/level_1/wall_8.png",
    "data/images/level_1/wall_9.png",
    "data/images/level_1/wall_10.png",
    "data/images/level_1/wall_11.png",
    "data/images/level_1/wall_12.png",
    "data/images/level_1/wall_13.png"
  ],
  "obstacles": [
    [1, 1, 1, 1, 1, 1, 1, 1, 1, 1, 1, 1, 1, 1, 1, 1, 1, 1, 1, 1, 1, 1, 1, 1, 1, 1],
    [1, 1, 1, 1, 1, 1, 1, 1, 1, 1, 1, 1, 1, 1, 1, 1, 1, 1, 1, 1, 1, 1, 1, 1, 1, 1],
    [1, 1, 1, 1, 1, 1, 1, 1, 1, 1, 1, 1, 1, 1, 1, 1, 1, 1, 1, 1, 1, 1, 1, 1, 1, 1],
    [1, 1, 1, 1, 1, 1, 1, 1, 0, 0, 0, 0, 0, 0, 1, 1, 1, 0, 0, 0, 0, 0, 0, 0, 1, 1],
    [1, 0, 0, 0, 0, 0, 1, 0, 0, 0, 0, 0, 0, 0, 0, 1, 0, 0, 0, 0, 0, 0, 0, 0, 1, 1],
    [1, 0, 0, 0, 0, 0, 1, 0, 0, 1, 0, 0, 1, 0, 0, 1, 0, 0, 0, 0, 0, 0, 0, 0, 1, 1],
    [1, 0, 0, 0, 0, 0, 0, 0, 0, 1, 0, 0, 1, 0, 0, 1, 0, 0, 0, 0, 0, 0, 0, 0, 1, 1],
    [1, 0, 0, 0, 0, 0, 0, 0, 0, 0, 0, 0, 0, 0, 0, 1, 0, 0, 0, 0, 0, 0, 0, 0, 1, 1],
    [1, 0, 0, 0, 0, 0, 1, 0, 0, 0, 0, 0, 0, 0, 0, 1, 0, 0, 0, 0, 0, 0, 0, 0, 1, 1],
    [1, 1, 1, 1, 1, 1, 1, 1, 0, 0, 0, 0, 0, 0, 1, 1, 1, 0, 0, 0, 0, 0, 0, 0, 1, 1],
    [1, 1, 1, 1, 1, 1, 1, 1, 1, 1, 1, 0, 0, 1, 1, 1, 1, 1, 1, 1, 0, 0, 1, 1, 1, 1],
    [1, 1, 1, 1, 1, 1, 1, 1, 1, 1, 1, 0, 0, 1, 1, 1, 1, 1, 1, 1, 0, 0, 1, 1, 1, 1],
    [1, 1, 1, 1, 1, 1, 1, 1, 1, 1, 1, 0, 0, 1, 1, 1, 1, 1, 1, 1, 0, 0, 1, 1, 1, 1],
    [1, 1, 1, 1, 1, 1, 1, 1, 1, 1, 1, 0, 0, 1, 1, 1, 1, 1, 1, 1, 0, 0, 1, 1, 1, 1],
    [1, 1, 1, 1, 1, 1, 1, 1, 1, 1, 1, 0, 0, 1, 1, 1, 1, 1, 1, 1, 0, 0, 1, 1, 1, 1],
    [1, 1, 1, 1, 1, 1, 1, 1, 0, 0, 0, 0, 0, 0, 0, 0, 0, 0, 1, 1, 0, 0, 1, 1, 1, 1],
    [1, 1, 1, 0, 0, 0, 1, 1, 0, 0, 0, 0, 0, 1, 1, 1, 0, 0, 1, 1, 0, 0, 1, 1, 1, 1],
    [1, 1, 1, 0, 0, 0, 0, 0, 0, 0, 0, 0, 0, 1, 1, 1, 0, 0, 1, 1, 0, 0, 1, 1, 1, 1],
    [1, 1, 1, 0, 0, 0, 0, 0, 0, 0, 0, 0, 0, 1, 1, 1, 0, 0, 0, 0, 0, 0, 1, 1, 1, 1],
    [1, 1, 1, 0, 0, 0, 1, 1, 0, 0, 0, 0, 0, 1, 1, 1, 1, 1, 1, 1, 1, 1, 1, 1, 1, 1],
    [1, 1, 1, 1, 1, 1, 1, 1, 1, 1, 1, 1, 1, 1, 1, 1, 1, 1, 1, 1, 1, 1, 1, 1, 1, 1]
  ],
  "front": [
    [0, 0, 0, 0, 0, 0, 0, 0, 0, 0, 0, 0, 0, 0, 0, 0, 0, 0, 0, 0, 0, 0, 0, 0, 0, 0],
    [0, 0, 0, 0, 0, 0, 0, 0, 0, 0, 0, 0, 0, 0, 0, 0, 0, 0, 0, 0, 0, 0, 0, 0, 0, 0],
    [0, 0, 0, 0, 0, 0, 0, 0, 0, 0, 0, 0, 0, 0, 0, 0, 0, 0, 0, 0, 0, 0, 0, 0, 0, 0],
    [0, 0, 0, 0, 0, 0, 0, 0, 0, 0, 0, 0, 0, 0, 0, 0, 0, 0, 0, 0, 0, 0, 0, 0, 0, 0],
    [0, 0, 0, 0, 0, 0, 0, 0, 0, 7, 0, 0, 8, 0, 0, 0, 0, 0, 0, 0, 0, 0, 0, 0, 0, 0],
    [0, 0, 0, 0, 0, 0, 0, 0, 0, 0, 0, 0, 0, 0, 0, 0, 0, 0, 0, 0, 0, 0, 0, 0, 0, 0],
    [0, 0, 0, 0, 0, 0, 0, 0, 0, 0, 0, 0, 0, 0, 0, 0, 0, 0, 0, 0, 0, 0, 0, 0, 0, 0],
    [0, 0, 0, 0, 0, 0, 6, 0, 0, 0, 0, 0, 0, 0, 0, 0, 0, 0, 0, 0, 0, 0, 0, 0, 0, 0],
    [0, 6, 6, 2, 7, 2, 0, 8, 0, 0, 0, 0, 0, 0, 6, 0, 8, 0, 0, 0, 0, 0, 0, 0, 0, 0],
    [0, 0, 0, 0, 0, 0, 0, 0, 2, 6, 6, 0, 0, 2, 0, 0, 0, 6, 7, 6, 0, 0, 6, 6, 0, 0],
    [0, 0, 0, 0, 0, 0, 0, 0, 0, 0, 0, 0, 0, 0, 0, 0, 0, 0, 0, 0, 0, 0, 0, 0, 0, 0],
    [0, 0, 0, 0, 0, 0, 0, 0, 0, 0, 0, 0, 0, 0, 0, 0, 0, 0, 0, 0, 0, 0, 0, 0, 0, 0],
    [0, 0, 0, 0, 0, 0, 0, 0, 0, 0, 0, 0, 0, 0, 0, 0, 0, 0, 0, 0, 0, 0, 0, 0, 0, 0],
    [0, 0, 0, 0, 0, 0, 0, 0, 0, 0, 0, 0, 0, 0, 0, 0, 0, 0, 0, 0, 0, 0, 0, 0, 0, 0],
    [0, 0, 0, 0, 0, 0, 0, 0, 0, 0, 0, 0, 0, 0, 0, 0, 0, 0, 0, 0, 0, 0, 0, 0, 0, 0],
    [0, 0, 0, 0, 0, 0, 0, 0, 0, 0, 0, 0, 0, 7, 2, 2, 0, 0, 0, 0, 0, 0, 0, 0, 0, 0],
    [0, 0, 0, 0, 0, 0, 0, 0, 0, 0, 0, 0, 0, 0, 0, 0, 0, 0, 0, 0, 0, 0, 0, 0, 0, 0],
    [0, 0, 0, 0, 0, 0, 0, 0, 0, 0, 0, 0, 0, 0, 0, 0, 0, 0, 0, 0, 0, 0, 0, 0, 0, 0],
    [0, 0, 0, 0, 0, 0, 2, 2, 0, 0, 0, 0, 0, 0, 0, 0, 2, 8, 8, 8, 2, 2, 0, 0, 0, 0],
    [0, 0, 0, 2, 6, 6, 0, 0, 6, 7, 2, 7, 0, 0, 0, 0, 0, 0, 0, 0, 0, 0, 0, 0, 0, 0],
    [0, 0, 0, 0, 0, 0, 0, 0, 0, 0, 0, 0, 0, 0, 0, 0, 0, 0, 0, 0, 0, 0, 0, 0, 0, 0]
  ],
  "back": [
    [2, 2, 5, 3, 5, 2, 2, 6, 6, 8, 6, 7, 6, 6, 2, 2, 8, 2, 2, 8, 8, 2, 7, 7, 6, 2],
    [8, 6, 6, 4, 6, 6, 8, 8,12,12,12,13,12,12, 6, 2, 6,12,12,12,11,12,12,13, 6, 2],
    [2,12,12,14,13,12, 7,13, 9, 9,10,10, 9, 9,12, 2,11, 9, 9, 9, 9, 9, 9, 9, 6, 2],
    [6, 9, 9, 9,10, 9, 6, 9, 1, 1, 1, 1, 1, 1, 9, 6, 9, 1, 1, 1, 1, 1, 1, 1, 7, 2],
    [2, 1, 1, 1, 1, 1,12, 1, 1, 1, 1, 1, 1, 1, 1, 8, 1, 1, 1, 1, 1, 1, 1, 1, 6, 2],
    [2, 1, 1, 1, 1, 1,11, 1, 1,14, 1, 1,11, 1, 1, 8, 1, 1, 1, 1, 1, 1, 1, 1, 7, 2],
    [6, 1, 1, 1, 1, 1, 1, 1, 1,13, 1, 1,12, 1, 1, 6, 1, 1, 1, 1, 1, 1, 1, 1, 2, 2],
    [2, 1, 1, 1, 1, 1, 1, 1, 1, 1, 1, 1, 1, 1, 1, 6, 1, 1, 1, 1, 1, 1, 1, 1, 2, 2],
    [2, 1, 1, 1, 1, 1, 6, 1, 1, 1, 1, 1, 1, 1, 1, 6, 1, 1, 1, 1, 1, 1, 1, 1, 6, 2],
    [2, 2, 6, 7, 8, 2, 2, 2, 1, 1, 1, 1, 1, 1, 7, 3, 6, 1, 1, 1, 1, 1, 1, 1, 2, 2],
    [3, 3, 3, 5, 3, 5, 5, 5, 3, 2, 8, 1, 1, 2, 2, 4, 7, 7, 7, 7, 1, 1, 6, 7, 6, 2],
    [2, 2, 2, 2, 2, 2, 2, 2, 2, 2, 2, 1, 1, 6, 5, 5, 5, 4, 5, 8, 1, 1, 8, 2, 2, 2],
    [2, 2, 2, 2, 2, 2, 2, 7, 7, 8, 2, 1, 1, 6, 2, 2, 2, 3, 2, 8, 1, 1, 7, 2, 2, 2],
    [2, 2, 6, 6, 8, 6, 2, 6,12,12,12, 1, 1,12,11,11,12,13, 2, 6, 1, 1, 6, 2, 2, 2],
    [2, 2, 2,11,11,11, 8, 8, 9, 9, 9, 1, 1, 9, 9, 9, 9, 9, 2, 2, 1, 1, 6, 2, 2, 2],
    [2, 2, 6, 9, 9, 9,12,12, 1, 1, 1, 1, 1, 1, 1, 1, 1, 1, 7, 7, 1, 1, 6, 2, 2, 2],
    [2, 2, 6, 1, 1, 1,12,12, 1, 1, 1, 1, 1, 7, 8, 6, 1, 1,11,12, 1, 1, 7, 2, 2, 2],
    [2, 2, 6, 1, 1, 1, 1, 1, 1, 1, 1, 1, 1, 7, 2, 2, 1, 1,10,10, 1, 1, 6, 2, 2, 2],
    [2, 2, 8, 1, 1, 1, 1, 1, 1, 1, 1, 1, 1, 6, 2, 6, 1, 1, 1, 1, 1, 1, 6, 2, 2, 2],
    [2, 2, 7, 1, 1, 1, 6, 7, 1, 1, 1, 1, 1, 6, 2, 6, 7, 2, 2, 2, 7, 2, 6, 2, 2, 2],
    [2, 2, 6, 6, 2, 2, 2, 8, 2, 2, 2, 6, 2, 2, 2, 2, 2, 2, 2, 2, 2, 2, 6, 2, 2, 2]
  ]
}