{
  "start_position": {
    "x": 100,
    "y": 50
  },
  "tiles": [
    false,
    "data/images/level_1/tile_1.png",
    "data/images/level_1/wall_1.png",
    "data/images/level_1/wall_2.png",
    "data/images/level_1/wall_3.png",
    "data/images/level_1/wall_4.png",
    "data/images/level_1/wall_5.png",
    "data/images/level_1/wall_6.png",
    "data/images/level_1/wall_7.png",
    "data/images/level_1/wall_8.png",
    "data/images/level_1/wall_9.png",
    "data/images/level_1/wall_10.png",
    "data/images/level_1/wall_11.png",
    "data/images/level_1/wall_12.png",
    "data/images/level_1/wall_13.png"
  ],
  "obstacles": [
    [1, 1, 1, 1, 1, 1, 1, 1, 1, 1, 1, 1, 1, 1, 1, 1],
    [1, 1, 1, 1, 1, 1, 1, 1, 0, 0, 0, 0, 0, 0, 1, 1],
    [1, 0, 0, 0, 0, 0, 1, 0, 0, 0, 0, 0, 0, 0, 0, 1],
    [1, 0, 0, 0, 0, 0, 1, 0, 0, 1, 0, 0, 1, 0, 0, 1],
    [1, 0, 0, 0, 0, 0, 0, 0, 0, 1, 0, 0, 1, 0, 0, 1],
    [1, 0, 0, 0, 0, 0, 0, 0, 0, 0, 0, 0, 0, 0, 0, 1],
    [1, 0, 0, 0, 0, 0, 1, 0, 0, 0, 0, 0, 0, 0, 0, 1],
    [1, 1, 1, 1, 1, 1, 1, 1, 0, 0, 0, 0, 0, 0, 1, 1],
    [1, 1, 1, 1, 1, 1, 1, 1, 1, 1, 1, 1, 1, 1, 1, 1]
  ],
  "front": [
    [0, 0, 0, 0, 0, 0, 0, 0, 0, 0, 0, 0, 0, 0, 0, 0],
    [0, 0, 0, 0, 0, 0, 0, 0, 0, 0, 0, 0, 0, 0, 0, 0],
    [0, 0, 0, 0, 0, 0, 0, 0, 0, 7, 0, 0, 8, 0, 0, 0],
    [0, 0, 0, 0, 0, 0, 0, 0, 0, 0, 0, 0, 0, 0, 0, 0],
    [0, 0, 0, 0, 0, 0, 0, 0, 0, 0, 0, 0, 0, 0, 0, 0],
    [0, 0, 0, 0, 0, 0, 6, 0, 0, 0, 0, 0, 0, 0, 0, 0],
    [0, 6, 6, 2, 7, 2, 0, 8, 0, 0, 0, 0, 0, 0, 6, 0],
    [0, 0, 0, 0, 0, 0, 0, 0, 2, 6, 6, 2, 2, 2, 0, 0],
    [0, 0, 0, 0, 0, 0, 0, 0, 0, 0, 0, 0, 0, 0, 0, 0]
  ],
  "back": [
    [2,12,12,14,13,12, 2,13, 9, 9,10,10, 9, 9,12, 2],
    [6, 9, 9, 9,10, 9, 6, 9, 1, 1, 1, 1, 1, 1, 9, 6],
    [2, 1, 1, 1, 1, 1,12, 1, 1, 1, 1, 1, 1, 1, 1, 8],
    [2, 1, 1, 1, 1, 1,11, 1, 1,14, 1, 1,11, 1, 1, 8],
    [6, 1, 1, 1, 1, 1, 1, 1, 1,13, 1, 1,12, 1, 1, 6],
    [2, 1, 1, 1, 1, 1, 1, 1, 1, 1, 1, 1, 1, 1, 1, 6],
    [2, 1, 1, 1, 1, 1, 6, 1, 1, 1, 1, 1, 1, 1, 1, 6],
    [2, 2, 6, 7, 8, 2, 2, 2, 1, 1, 1, 1, 1, 1, 7, 3],
    [3, 3, 3, 5, 3, 5, 5, 5, 3, 2, 8, 2, 2, 2, 2, 4]
  ]
}